2 Player Map1
WSWSWSWSWS
SWSWSGSWSW
WSGSFFGSWS
FGFGFGFGFG
F78888889G
F45555556F
G12222223F
GFGFGFGFGF
FGFGFGFGFG
GFGFGFGFGF