2 Player Map2
SWSWSWSWSW
WSWSWSWSFS
SFGWGGSFFG
WSWGFSGG78
SWSWSFFG45
GFGFGFGF45
FGFGFGFG12
GFGFGFGFGF
FGFGFGFGFG
GFGFGFGFGF