2 Player Map3
SSSSWWSF45
SWSSWSWS12
SSSWSSSWSW
WSSGFGWGWS
RRRRRRRRRR
WSWGFGWGGS
FWFFGFSFGG
GF79GFFSFG
SW13SFFFGG
GSGGWSGSGG