4 Player Map 2
WSWSWSWSFGGSWSWSWSWS
SWSWFFSWSWSWSWSWSWSW
WSFGWSWSWSWFFSWSWSWS
SWSWSFGWFGGFSFGWFWSW
WSWSGGFFGGFGFFFGGSWS
SWSWG7888888889GGFSW
WSWSF4555555556FSFWS
SWSGG4555555556FGGSW
FWSFG4555555556SGSGF
WSWGF1222222223GWGGS
RRRRRRRRRRRRRRRRRRRR
GFGGG7888888889FFSFG
SWGGS4555555556FFFGG
GSGGW4555555556SGSGG
GFGGG4555555556SGSGG
SWGGS1222222223FFSFG
FWSFGFSFGGSWGGSFFFGG
GSGGWSGSGGGSGGWSGSGG
GFGGGFFSFGGSGGWSGSGG
SWGGSFFFGGSWGGSFFFGG