4 Player Map 4
FGG78888888888889GGF
FSF45555555555556GSF
FGF45555555555556GWF
FSG45555555555556FFF
FFF45555555555556FGF
FGG45555555555556GSF
FWF45555555555556GFF
FWG45555555555556FGF
WWF12222222222223GGS
RRRRRRRRRRRRRRRRRRRR
FGFGGGFFFWFGGSGGFGFF
GF78888889788888889F
WF45555556455555556G
SG12222223122222223F
FGFGGFFGFFFFGGGFFGGF
RRRRRRRRRRRRRRRRRRRR
FGFGF788888889FGSGSG
WFSGG455555556GSWGFW
FGWSF455555556FGWWSF
FGGGG455555556GFFFWS