4 Player Map 3
FFG456FG456FG4556GFG
GFF123FS456FG4556GGW
SWGGFFGG456GW4556FSW
FGGFFFGF123FG4556FGG
FGFGGFGFGFGGF1223FGG
GFGFFFFGGFGFGFGGFGFG
888888889FGSWWSFSSFG
555555556GFFWSWGSWWW
555555556FFSGWFGSSSW
555555556FSFFGSWFGWG
222222223GSSWFSFGGGF
FGFGFFFGGFGGSFF78888
FGWFFGFGFFGSGGF45555
GGGFFSFGWSSFGFF45555
FGSGGFFFGGSWGFG12222
RRRRRRRRRRRRRRRRRRRR
SFGGWG78889FGWSFGWGF
GFGWGF45556FWSGFFGGS
GGFSFF45556GFFFWGGWG
WWGGFG45556FGGWSWFGF