4 Player Map 1
FGFGFGF455556FFGFGFG
GFGFGFG455556GGFGFGF
FGFGFGF455556FFGFGFG
GFGFGFG455556GGFGFGF
FGFGFGF455556FFGFGFG
GFGFGFG122223GGFGFGF
FGFGFGFGFGFGFGFGFGFG
GFGFGFGFGFGFGFGFGFGF
888889FGFGFGFG788888
555556GFGFGFGF455555
555556FGFGFGFG455555
222223GFGFGFGF122222
FGFGFGFGFGFGFGFGFGFG
GFGFGFGFGFGFGFGFGFGF
FGFGFGF788889GFGFGFG
GFGFGFG455556FGFGFGF
FGFGFGF455556GFGFGFG
GFGFGFG455556FGFGFGF
FGFGFGF455556GFGFGFG
GFGFGFG455556FGFGFGF